# # # # # # # # # # # # # # # # #
# T . . . . . . . . . # . # . . #
# # # # # # # # # . . . . # . # #
# . . . . . . . . . # . . . . . #
# . # # # . # . # . # . # . # . #
# . # . # . # . # . # . # . # . #
# . # . # . # . # . . # # . # # #
# . # . . . # . # # . # . . . . #
# # . . # # # . . # . # . . # # #
# . . # . . . . # # . # # . . . #
# # # # . # . . . # . # . . # # #
# . . . . # . # . # . # # . # . #
# . # # . # . # . # . . # . . . #
# # # # # # # # # # # # # # # S #
